
F 186,195,201
C 135,206,235

1111111111
1000000001
1000000001
1000000001
1111111111