111111111111111111111111111111111111111
100000000000000000000000000000000000001
100000000000000000000000000000010000001
100000000000000000000000000000010000001
100000000000000P00000000000000010000001
100000000000000000000000000000010000001
100000000000000000000000000000010000001
100000000000000000000000000000010000001
100000000000000000000000000000010000001
100000000000000000000000000000000000001
100000000000000000000000000000000000001
100000000000011111111111100000000000001
100000000000000000000000000000000000001
100000000000000000000000000000000000001
100000000000000000000000000000000000001
100000000000000000000000000000000000001
100000000000000000000000000000000000001
100000001111111110000000000000000000001
100000000000000000000000000000000000001
111111111111111111111111111111111111111