NO ./png/no.png
SO ./png/so.png
WE ./png/we.png
EA ./png/ea.png

F 119,127,122
C 0,14,5

        1111111111 111111111111111
        100000000011000N0000000000111
        10110000011100000000000011
        1001000000001111111111111
111111111011000000001
1000000000110000000011111111111111
11110111111111011100000010001
11110111111111011101010010001
11111111111111111110000000001
10000001 10000001 100000011011
10000001110000001 101010011111
1100000111010101111101111000111
11110111 1110101 101111010001
11111111 1111111 111111111111