111111111111111111111111
100000000000000000010001
10000P000000000000010001
100000000000000000010001
100000000000000000000001
100000000000000000000001
100111111111111000000001
100000000000000000000001
101111100000000000000001
100000000000000000000001
111111111111111111111111