NO ./path_to_the_north_texture
SO ./path_to_the_south_texture  
WE ./path_to_the_west_texture
EA ./path_to_the_east_texture
F 225, 5, 6
C 225,30,0

111111111111111111
100000000011000001
111100000111000001
   1111001111111111111
111100000000000001
111111111011000001
100000000011000001
111101111111110111
111100001000000111
110000011100000111
100000001000000011
10000000N000000011
110000011101010111
111111111111111111