NO ./png/no.png
SO ./png/so.png
WE ./png/we.png
EA ./png/ea.png
F 225, 5, 6
C 225,30,0

11111111111111111
100000000000000001
100000010100000011
1000000101000001
110100011100N001
1001111000001111
1000000111000001
11111111111111111