1111111111111111111111111111111111111111
1000000000000000000000000000000000000001
1001111000000000000000000000000000110001
1000000000000111111111111110000000000001
1000000000000000000000000000000000000001
1000000000000111111100000000010000000001
1000000000000000000000000000010000000001
1000001111100000000000000000010000000001
1000000000000000000000000000010000000001
1000100000000011111100000000000000000001
100000N000000000000000000000000000000001
1000000000000000000000000000011111000001
1000001100000000000111111111110000000001
1000000000000000000000000000000000000001
1111111111111111111111111111111111111111