11111111111111111111111111111111111
10000000000000000000000000000000001
10000000000000000000000000000000001
10000111110000000000000000000000001
10000000000000000000000000000000001
1000000N000000000001000000000000001
10000000000000000000000000000000001
10000000000000000000000000000000001
11111111111111111111111111111111111