1111111111111111111111111
1010000000000000000000001
10100N0001000000000000001
1010000000000000000000001
1000000001000000000000001
1000000000000000000000001
1000000001000000000000001
1000000000000000000000001
1011111001000000000000001
1000000001000000000000001
1111111111111111111111111