NO ./png/no.png
SO ./png/so.png
WE ./png/we.png
EA ./png/ea.png
F 225, 5, 6
C 225,30,0

111111111111111111111
100000000000000000101
100000010100010000111
100000010100000000101
110100011100000000101
100111100000000000111
1000000111000N0000101
100000011100000000101
100000011100000000101
100000011100000000101
100000011100000000101
111111111111111111111