NO ./path_to_the_north_texture
SO ./path_to_the_south_texture  
WE ./path_to_the_west_texture
EA ./path_to_the_east_texture
F 225, 5, 6
C 225,30,0

1111111111111111111111111
1000000000110000000000001
1111000001110000000000001
   11110011111111111111111111
1111000000000000000000001
1111111110110000011100001
1000000000110000011101111
1111011111111101110000001
1111011111111101110101001
1100000011010101110000001
1000000000000000110000001
10000000N0000000110101001
1100000111010101111101111
1111111111111111111111111