NO ./png/no.png
SO ./png/so.png
WE ./png/we.png
EA ./png/ea.png
F 225, 5, 6
C 225,30,0

1111111111111111111
1000000000000000001
10000001D10000000011
100000010100000101
110100011100N00101
100111100000001111
100000011100000101111111
1001111000000011111
1000000111000000101
1111111111111111111