NO ./png/no.png
SO ./png/so.png
WE ./png/we.png
EA ./png/ea.png
F 225, 5, 6
C 225,30,0

1111111111111111111111111111
10000000000000000000000000001
10000001D10000000000000000011
100000010100000100100100101
110100011100N00100100100101
100111100000111111111111111
100000011100000100100100101
1001111000001111111111111111
100000011100000100100100101
100000011100000100100100101
1111111111111111111111111111