NO ./png/no.png
SO ./png/so.png
WE ./png/we.png
EA ./png/ea.png
F 119, 127, 122
C 0, 14, 5

1111111111111111111111111111111111111111111111111111111111111111111111111111111111111111111
1000000000000000000000000000000000000000000000000000000000000000000000000000000000000000001
1111111111111111111111111111111111111111111111111111111111111111111111111111111111111111101
                      101                               101                             101
                      101                               101                             101
          1111111111111111111111111111111111            101                             101
          1000000000000000000000000000000001            101                             101
          1011111111111111111111111111111101            111                             101
          101         101                101            101                             101
          101         101                101            101                             101
1111111111101111111111111111111111111111110111111111111110111                           111
1000000000100000000000000100000000000000000000000000000000001                           101
1000000000100000000000000100000000000000000000000000000000001111111111111111111111111111101
1000000000100000000000000100000000000000000000000000000000000000000000000000000000000000001
1000000000100000000000000100000000000000000000000000000000000000000000000000000000000000001
1000000000100000000000000100000000000000000000000000000000000000000000000000000000000000001
1000000000100000000000000100000000000000000000000000000000000000000000000000000000000000001
1000000000100000000000000100000000000000000000000000000000000000000000000000000000000000001
1000000000100000000000000100000000000000000000000000000000000000000000000000000000000000001
1000000000100000000000000100000000000000000000000000000000000000000000000000000000000000001
1000000000100000000000000100000000000000000000000000000000000000000000000000000000000000001
1000000000100000000000000100000000000000000000000000000000000000000000000000000000000000001
1000000000100000000000000100000000000000000000000000000000000000000000000000000000000000001
1000000000100000000000000100000000000000000000000000000000000000000000000000000000000000001
1000000000100000000000000100000000000000000000000000000000000000000000000000000000000000001
1000000000100000000000000100000000000000000000000000000000000000000000000000000000000000001
1000000000100000000000000100000000000000000000000000000000000000000000000000000000000000001
1000000000100000000000000100000000000000000000000000000000001111111111111111111111111111101
1000000000100000000000000000000000000000000000000000000000001                           101
1000000000100000000000000000000000000000000000000000000000001                           101
100000000010000011110000010000000000S000000000000000000000001                           101
1000000000111111100100000100000000000000000000000000000000001                           101
1000000000000000000100000000000000000000000000000000000000001                           101
1000000000000000000000000001000000000000000000000000000000001                           101
1000000000000000000000000001000000000000000000000000000000001                           101
1000000000000000000000000001000000111111111110000000000000001                           101
1000000000000000000000000001000000000000000000000000000000001                           101
1000000000000000000000001001000000000000000000000000000000001                           101
1000000000000000000000000001000000000000000000000000000000001                           101
1000000000000000000000000001000000000000000000000000000000001                           101
1000000000000000000000000001000000000000000000000000000000001                           101
1000000000000000000000000001000000000000000000000000000000001111111111111111111111111111101
1000000000000000000000000000000000000000000000000000000000001000000000000000000000000000001
1111111111111111111111111111111111111111111111111111111111111111111111111111111111111111111
