NO ./png/no.png
SO ./png/so.png
WE ./png/we.png
EA ./png/ea.png
F 225, 5, 6
C 225,30,0

1111111111111111111111111111111111111111111111111111111111111111111
1000000000000000000000000000000000000000000000000001
10000000000000000000000000000000000000000000000000011
1000000000000000000000000000000000000000000000001011
11010000010N0000000000000000000000000000000000000101
1001111000000000000000000000000000000000000000011111
100000011100000000000000000000000000000000000000101111111
1001111000000000000000000000000000000000000000011111
1000000111000000000000000000000000000000000000000101
100000011100000000000000000000000000000000000000101111111
1001111000000000000000000000000000000000000000011111
1000000111000000000000000000000000000000000000000101
100000011100000000000000000000000000000000000000101111111
1001111000000000000000000000000000000000000000011111
1000000111000000000000000000000000000000000000000101
100000011100000000000000000000000000000000000000101111111
1001111000000000000000000000000000000000000000011111
1000000111000000000000000000000000000000000000000101
100000011100000000000000000000000000000000000000101111111
1001111000000000000000000000000000000000000000011111
1000000111000000000000000000000000000000000000000101
100000011100000000000000000000000000000000000000101111111
1001111000000000000000000000000000000000000000011111
1000000111000000000000000000000000000000000000000101
100000011100000000000000000000000000000000000000101111111
1001111000000000000000000000000000000000000000011111
1000000111000000000000000000000000000000000000000101
100000011100000000000000000000000000000000000000101111111
1001111000000000000000000000000000000000000000011111
1000000111000000000000000000000000000000000000000101
100000011100000000000000000000000000000000000000101111111
1001111000000000000000000000000000000000000000011111
1000000111000000000000000000000000000000000000000101
100000011100000000000000000000000000000000000000101111111
1001111000000000000000000000000000000000000000011111
1000000111000000000000000000000000000000000000000101
100000011100000000000000000000000000000000000000101111111
1001111000000000000000000000000000000000000000011111
1000000111000000000000000000000000000000000000000101
100000011100000000000000000000000000000000000000101111111
1001111000000000000000000000000000000000000000011111
1000000111000000000000000000000000000000000000000101
100000011100000000000000000000000000000000000000101111111
1001111000000000000000000000000000000000000000011111
1000000111000000000000000000000000000000000000000101
100000011100000000000000000000000000000000000000101111111
1001111000000000000000000000000000000000000000011111
1000000111000000000000000000000000000000000000000101
100000011100000000000000000000000000000000000000101111111
1001111000000000000000000000000000000000000000011111
1000000111000000000000000000000000000000000000000101
100000011100000000000000000000000000000000000000101111111
1001111000000000000000000000000000000000000000011111
1000000111000000000000000000000000000000000000000101
100000011100000000000000000000000000000000000000101111111
1001111000000000000000000000000000000000000000011111
1000000111000000000000000000000000000000000000000101
100000011100000000000000000000000000000000000000101111111
1001111000000000000000000000000000000000000000011111
1000000111000000000000000000000000000000000000000101
100000011100000000000000000000000000000000000000101111111
1001111000000000000000000000000000000000000000011111
1000000111000000000000000000000000000000000000000101
100000011100000000000000000000000000000000000000101111111
1001111000000000000000000000000000000000000000011111
1000000111000000000000000000000000000000000000000101
100000011100000000000000000000000000000000000000101111111
1001111000000000000000000000000000000000000000011111
1000000111000000000000000000000000000000000000000101
100000011100000000000000000000000000000000000000101111111
1001111000000000000000000000000000000000000000011111
1000000111000000000000000000000000000000000000000101
100000011100000000000000000000000000000000000000101111111
1001111000000000000000000000000000000000000000011111
1000000111000000000000000000000000000000000000000101
100000011100000000000000000000000000000000000000101111111
1001111000000000000000000000000000000000000000011111
1000000111000000000000000000000000000000000000000101
100000011100000000000000000000000000000000000000101111111
1001111000000000000000000000000000000000000000011111
1000000111000000000000000000000000000000000000000101
100000011100000000000000000000000000000000000000101111111
1001111000000000000000000000000000000000000000011111
1000000111000000000000000000000000000000000000000101
100000011100000000000000000000000000000000000000101111111
1001111000000000000000000000000000000000000000011111
1000000111000000000000000000000000000000000000000101
100000011100000000000000000000000000000000000000101111111
1001111000000000000000000000000000000000000000011111
1000000111000000000000000000000000000000000000000101
100000011100000000000000000000000000000000000000101111111
1001111000000000000000000000000000000000000000011111
1000000111000000000000000000000000000000000000000101
1111111111111111111111111111111111111111111111111111111111111111111