NO ./png/no.png
SO ./png/so.png
WE ./png/we.png
EA ./png/ea.png
F 225, 5, 6
C 225,30,0

11111111111111111111111111111
10000000000000000000000000001
10000001D100000000000000000011
1000000101000000000000100101
110100011100N000000000100101
1001111000000000000000111111
1000000111000000000000100101111111
10011110000000000000001111111
10000001110000000000001000101
11111111111111111111111111111